all	DT
and	DT
animal	NN
ant	NN
ashes	NN
at	DT
back	JJ
bad	JJ
bark	NN
because	DT
belly	NN
big	JJ
bird	NN
bite	VB
black	JJ
blood	NN
blow	NN
bone	NN
breast	NN
breathe	VB
burn	VB
child	NN
cloud	NN
cold	JJ
come	VB
count	VB
cut	NN
day	NN
die	NN
dig	NN
dirty	JJ
dog	NN
drink	NN
dry	JJ
dull	JJ
dust	NN
ear	NN
earth	NN
eat	VB
egg	NN
eye	NN
fall	VB
far	JJ
fat	NN
father	NN
fear	NN
feather	NN
few	JJ
fight	NN
fingernail	NN
fire	VB
fish	NN
five	JJ
float	NN
flow	NN
flower	NN
fly	NN
fog	NN
foot	NN
four	JJ
freeze	NN
fruit	NN
full	JJ
give	VB
good	JJ
grass	NN
green	JJ
guts	NN
hair	NN
hand	NN
he	NN
head	NN
hear	VB
heart	NN
heavy	JJ
here	DT
hit	VB
hold	NN
horn	NN
how	DT
hunt	NN
husband	NN
I	NN
ice	NN
if	DT
in	DT
kill	VB
knee	NN
know	VB
lake	NN
laugh	NN
leaf	NN
left	JJ
leg	NN
lie	NN
live	VB
liver	NN
long	JJ
louse	NN
man	NN
many	JJ
meat	NN
moon	NN
mother	NN
mountain	NN
mouth	NN
name	NN
narrow	JJ
near	JJ
neck	NN
new	JJ
night	NN
nose	NN
not	JJ
old	JJ
one	JJ
other	JJ
person	NN
play	NN
pull	NN
push	NN
rain	NN
red	JJ
right	JJ
rightside	NN
river	NN
road	NN
root	NN
rope	NN
rotten	JJ
round	NN
rub	NN
salt	NN
sand	NN
say	VB
scratch	VB
sea	NN
see	VB
seed	NN
sew	VB
sharp	JJ
short	JJ
sing	VB
sit	VB
skin	NN
sky	NN
sleep	NN
small	JJ
smell	VB
smoke	NN
smooth	NN
snake	NN
snow	NN
some	DT
spit	NN
split	NN
squeeze	NN
stab	NN
stand	NN
star	NN
stick	NN
stone	NN
straight	JJ
suck	NN
sun	NN
swell	VB
swim	VB
tail	JJ
that	DT
there	DT
they	NN
thick	JJ
thin	JJ
think	NN
this	DT
thou	DT
three	JJ
throw	VB
tie	VB
tongue	NN
tooth	NN
tree	NN
turn	NN
two	JJ
vomit	NN
walk	VB
warm	JJ
wash	NN
water	NN
we	NN
wet	JJ
what	DT
when	DT
where	DT
white	NN
who	DT
wide	JJ
wife	NN
wind	NN
wing	NN
wipe	VB
with	DT
woman	NN
woods	NN
worm	NN
year	NN
yellow	JJ
you	NN